###########
#...x.....#
#.........#
#.......x.#
#.........#
#.o.......#
#.........#
#...p.....#
#.........#
#.........#
#.........# 
####...####
---#...#---
---#...#--- 
---#...#---
---#...#---
####...####
#...x.....#
#.........#
#.........#
#....#...x#
#.....#...#
#.........#
#...p.....#
#.........#
#.........#
#....@...o#
###########