#########
#...x...#
#.......#
#.#####.#
#.......#
#.......#
#.......#
#.......#
#.......#
#...@...#
#########