-----#...#-----
-----#...#-----
-----#...#-----
-----#...#-----
######!!!######
#.............#
#.............#
#.............#
#....#........#
#.....#.......#
#.....###.....#
#.............#
#.............#
#.............#
#.............#
#.............#
#.............#
######!!!######
-----#...#-----
-----#...#-----
-----#...#-----
-----#...#-----
######!!!######
#...x.........#
#.............#
#.............#
#....#...x....#
#.....#.......#
#.....###.....#
#...p.........#
#.............#
#.............#
#.............#
#.............#
#....@...o....#
###############